A is a point.	point_A
O is a point.	point_O
A point exists.	point_X
Point A exists.	point_A
Point B exists.	point_B
There is a point.	point_X
There exists a point.	point_X
A and B are two points.	points_A_B
AB is a straight line.	line_AB
A and B are two points connected by a line.	line_AB
A and B are two points connected by a straight line.	line_AB
O and P are two points connected by a line.	line_OP
O and P are two points connected by a straight line.	line_OP
Shortest path between two points is the straight line connecting them.	line_AB
A, B and C are three points.	points_A_B_C
Atleast 3 points are needed to form a triangle.	triangle_ABC
Atleast 3 points are required to form a triangle.	triangle_ABC
A triangle is a polygon having 3 sides.	triangle_ABC
A triangle is a three-sided polygon.	triangle_ABC
ABC is a triangle.	triangle_ABC
ABC is a polygon with 3 sides.	triangle_ABC
ABC is a polygon having 3 sides.	triangle_ABC
A, O and B are collinear points.	collinear_AOB
O is a point on a straight line AB.	line_AOB
The two straight lines AB and CD cross one another at point O.	lines_AB_CD
The two straight lines AB and CD intersect at point O.	lines_AB_CD
The two straight lines AB and CD cross at point O.	lines_AB_CD
Angles AOB and BOC have a common arm OB.	angles_AOB_BOC
Angle AOB and angle BOC have a common arm OB.	angles_AOB_BOC
Angles AOB and BOC are adjacent angles.	angles_AOB_BOC
Angle AOB and angle BOC are adjacent angles.	angles_AOB_BOC
Adjacent angles are angles having a common arm.	angles_AOB_BOC
Angle AOB is a acute angle.	acute_angle
Angle AOB is a obtuse angle.	obtuse_angle
Angle AOB is a right angle.	right_angle
Angle AOB is a straight angle.	straight_angle
Angle AOB is a reflex angle.	reflex_angle
Point M is the midpoint of line AB.	line_AMB
Point M is the middle point of line AB.	line_AMB
M is the midpoint of line AB.	line_AMB
M is the middle point of line AB.	line_AMB
Point M bisects the line AB.	line_AMB
M is the point of bisection of line AB.	line_AMB
Line segment OP bisects the angle AOB.	angle_AOB_bisector_OP
OP bisects the angle AOB.	angle_AOB_bisector_OP
Line OP bisects the angle AOB.	angle_AOB_bisector_OP
OP is the angle bisector of AOB.	angle_AOB_bisector_OP
OP is the angle bisector of angle AOB.	angle_AOB_bisector_OP
OP is the bisector of angle AOB.	angle_AOB_bisector_OP
Every angle has an angle bisector.	angle_AOB_bisector_OP
A straight line can be drawn from any point to any other point.	line_AB
If lines AB and CD intersect at point O, then angle AOC and angle DOB are called vertically opposite angles.	vertically_opposite_angles_AOC_DOB
If lines AB and CD cut one another at point O, then angle AOC and angle DOB are called vertically opposite angles.	vertically_opposite_angles_AOC_DOB
If lines AB and CD intersect at point O, then angle AOD and angle COB are called vertically opposite angles.	vertically_opposite_angles_AOD_COB
If lines AB and CD cut one another at point O, then angle AOD and angle COB are called vertically opposite angles.	vertically_opposite_angles_AOD_COB
If lines AB and CD intersect at point O, then angle AOC and angle AOD are adjacent angles.	adjacent_angles_AOC_AOD
If lines AB and CD intersect at point O, then angle BOC and angle BOD are adjacent angles.	adjacent_angles_BOC_BOD
If lines AB and CD intersect at point O, then angle DOA and angle DOB are adjacent angles.	adjacent_angles_DOA_DOB
If lines AB and CD intersect at point O, then angle COA and angle COB are adjacent angles.	adjacent_angles_COA_COB
If AB is straight line and O is point on AB, then angle AOB is called a straight angle.	straight_angle
Sum of two right angles is a straight angle.	sum_right_angles
If angles AOP and BOP are two right angles then their sum angle AOB is a straight angle.	sum_right_angles
If lines AB and CD intersect at point O, then angles AOC and AOD are adjacent angles on the same side of CD.	adjacent_angles_AOC_AOD
If lines AB and CD intersect at point O, then angles BOC and BOD are adjacent angles on the same side of CD.	adjacent_angles_BOC_BOD
If lines AB and CD intersect at point O, then angles DOA and DOB are adjacent angles on the same side of AB.	adjacent_angles_DOA_DOB
If lines AB and CD intersect at point O, then angles COA and COB are adjacent angles on the same side of AB.	adjacent_angles_COA_COB
If lines AB and CD intersect at point O, then sum of angles AOC and AOD are is equal to two right angles.	adjacent_angles_sum_two_right_angles
If lines AB and CD intersect at point O, then angles AOC and AOD are together equal to two right angles.	adjacent_angles_sum_two_right_angles
Adjacent angles which one straight line makes with another straight line on one side of it, are together equal to two right angles.	adjacent_angles_sum_two_right_angles
If two straight lines cut one another, the four angles so formed are together equal to four right angles.	four_angles_sum_four_right_angles
If two straight lines cut one another, the four angles so formed are equal to four right angles.	four_angles_sum_four_right_angles
Two angles are called complementary if their sum is equal to right angle.	complementary_angles
If the sum of angles AOP and POB is equal to a right angle, then angles AOB and POB are called complementary angles.	complementary_angles
If angles AOP and POB together equal a right angle, then angles AOB and POB are called complementary angles.	complementary_angles
Angles AOP and POB are complementary angles.	complementary_angles
Two angles are called complementary if their sum is equal to a right angle.	complementary_angles
Two angles are called supplementary if their sum is equal to two right angles.	right_supplementary_angles
Two angles are called supplementary if their sum is equal to a straight angle.	supplementary_angles
If the sum of angles AOP and POB is equal to two right angles, then angles AOP and POB are called supplementary angles.	right_supplementary_angles
If angles AOP and POB together equal to two right angles, then angles AOP and POB are called supplementary angles.	right_supplementary_angles
Two angles are called supplementary if their sum is equal to a straight angle.	supplementary_angles
If the sum of angles AOP and POB is equal to a straight angle, then angle AOP and POB are called supplementary angles.	supplementary_angles
If angles AOP and POB together equal to a straight angle, then angles AOP and POB are called supplementary angles.	supplementary_angles
Angles AOP and POB are supplementary angles.	supplementary_angles
If two straight lines intersect forming four angles of which one is known to be a right angle, prove that the other three are also right angles.	perpendicular_line_intersection
In the triangle ABC the angles ABC, ACB are given equal. If the side BC is produced both ways, show that the exterior angles so formed are equal.	equal_exterior_angles_isosceles_triangle
In the triangle ABC the angles ABC, ACB are given equal. If AB and AC are produced beyond the base, show that the exterior angles so formed are equal.	equal_exterior_angles_isosceles_triangle_1
OP is the internal bisector of angle AOB.	angle_AOB_bisector_OP
OP is the internal angle bisector of angle AOB.	angle_AOB_bisector_OP
OP is the angle bisector of angle AOB.	angle_AOB_bisector_OP
OP is the external bisector of angle AOB.	angle_AOB_external_bisector_OP
OP is the external angle bisector of angle AOB.	angle_AOB_external_bisector_OP
OP and OQ are internal and external bisectors of angle AOB.	angle_AOB_bisectors_OP_OQ
Prove that the bisectors of the adjacent angles which one straight line makes with another contain a right angle.	adjacent_angles_right_bisectors
The internal and external bisector of an angle are at right angle to one another.	adjacent_angles_right_bisectors
If OP and OQ are internal and external bisectors of angle AOB, then angle AOP and angle COQ are complementary.	angle_AOB_bisectors_OP_OQ
If OP and OQ are internal and external bisectors of angle AOB, then show that the angles BOP and COP are supplementary.	angle_AOB_bisectors_OP_OQ
If OP and OQ are internal and external bisectors of angle AOB, then show that the angles AOQ and BOQ are supplementary.	angle_AOB_bisectors_OP_OQ
If two straight lines cut one another, the vertically opposite angles are equal.	equal_vertically_opposite_angles
If from O, a point in AB, two straight lines OC, OD are drawn on opposite sides of AB so as to make the angle COB equal to the angle AOD. Show that OC and OD are in the same straight line.	vertically_opposite_angles_AOD_COB
Two straight lines AB, CD cross at O. If OX is the bisector of the angle BOD, prove that XO produced bisects the angle AOC.	bisecting_vertically_opposite_angles
A triangle is a plane figure bounded by three straight lines.	triangle_ABC
A quadrilateral is a plane figure bounded by four straight lines.	quadrilateral_ABCD
ABCD is a polygon with four sides.	quadrilateral_ABCD
ABCD is a  four-sided polygon.	quadrilateral_ABCD
ABCD is a quadrilateral.	quadrilateral_ABCD
ABC is a polygon with three sides.	triangle_ABC
ABC is a three-sided polygon.	triangle_ABC
ABCDE is a polygon with five sides.	pentagon_ABCDE
ABCDE is a five-sided polygon.	pentagon_ABCDE
ABCDE is a pentagon.	pentagon_ABCDE
ABCDEF is a polygon with six sides.	hexagon_ABCDEF
ABCDEF is a six-sided polygon.	hexagon_ABCDEF
ABCDEF is a hexagon.	hexagon_ABCDEF
A triangle is equilateral if all its sides are equal.	equilateral_triangle
A triangle is equiangular if all its angles are equal.	equiangular_trinagle
A triangle is regular when it is both equilateral and equiangular.	regular_triangle
ABC is regular triangle.	regular_triangle
If a triangle is equiangular, then it is also equilateral.	equiangular_equilateral
If a triangle is equilateral, then it is also equiangular.	equilateral_equiangular
A quadrilateral is equilateral if all its sides are equal.	equilateral_quadrilateral
ABCD is a rhombus.	equilateral_quadrilateral
A quadrilateral is equiangular if all its angles are equal.	equiangular_quadrilateral
ABCD is a rectangle.	equiangular_quadrilateral
A quadrilateral is regular when it is both equilateral and equiangular.	regular_quadrilateral
If ABCD is a quadrilateral, then AC and BD are called diagnols.	quadrilateral_diagnols
ABCD is a regular quadrilateral.	regular_quadrilateral
ABCD is a square.	regular_quadrilateral
A triangle is isosceles if two of its sides are equal.	isosceles_triangle
ABC is a right-angled triangle.	right_triangle
ABC is a obtuse-angled triangle.	obtuse_triangle
ABC is a acute-angled triangle.	acute_triangle
A triangle is scalene if all its sides are unequal.	triangle_ABC
In any triangle the straight line joining a vertex to the middle point of the opposite side is called a median.	triangle_median
In any triangle the straight line joining a vertex to the midpoint of the opposite side is called a median.	triangle_median
Triangles ABC and XYZ are equilateral and congruent.	equilateral_congruent
Triangles ABC and XYZ are equilateral and equal in all respects.	equilateral_congruent
Triangles ABC and XYZ are isosceles and congruent.	isosceles_congruent
Triangles ABC and XYZ are isosceles and equal in all respects.	isosceles_congruent
Triangles ABC and XYZ are scalene and congruent.	scalene_congruent
Triangles ABC and XYZ are scalene and equal in all respects.	scalene_congruent
Triangles ABC and XYZ are congruent.	scalene_congruent
Triangles ABC and XYZ are equal in all respects.	scalene_congruent
If two triangles have two sides of the one equal to two sides of the other, each to each, and the angles included by those sides equal, then the triangles are equal in all respects.	SAS_congruent
If two triangles have two sides of the one equal to two sides of the other, each to each, and the angles included by those sides equal, then the triangles are congruent.	SAS_congruent
Show that the bisector of the vertical angle of an isosceles triangle bisects the base.	vertical_isosceles_bisector_bisector
Show that the bisector of the vertical angle of an isosceles triangle is perpendicular to the base.	vertical_isosceles_bisector_perpendicular
Let O be the middle point of a straight line AB, and let OC be perpendicular to it. If P is any point in OC, prove that PA = PB.	midpoint_perpendicular_equal_sides
A quadrilateral all whose sides are equal and all whose angles are right angles is called a square.	regular_quadrilateral
A quadrilateral all whose sides are equal and whose opposite sides are parallel is called a rhombus.	equilateral_quadrilateral
A quadrilateral whose opposite sides are equal and all whose angles are right angles is called a rectangle.	rectangle
A quadrilateral whose opposite sides are equal and parallel is called a parallelogram.	parallelogram
In a square ABCD, the diagnols AC and BD are equal.	square_diagnols
ABCD is a square, and L, M, and N are the middle points of AB, BC, and CD. Prove that LM = MN.	square_midpoints_1
ABCD is a square, and L, M, and N are the middle points of AB, BC, and CD. Prove that AM = DM.	square_midpoints_2
ABCD is a square, and L, M, and N are the middle points of AB, BC, and CD. Prove that AN = AM.	square_midpoints_3
ABCD is a square, and L, M, and N are the middle points of AB, BC, and CD. Prove that BN = DM.	square_midpoints_4
ABC is an isosceles triangle. From the equal sides AB, AC two equal parts AX, AY are cut off, and BY and CX are joined. Prove that BY = CX.	isosceles_cross_connection
The angles at the base of an isosceles triangle are equal.	isosceles_angles
If the equal sides AB, AC of an isosceles triangle are produced, the exterior angles EBC, FCB are equal.	isosceles_exterior_angles
If the equal sides AB, AC of an isosceles triangle are produced, the exterior angles EBC, FCB are equal, for they are the supplements of the equal angles at the base.	isosceles_interior_exterior_angles
ABC is a an isosceles triangle with AB and AC being the equal sides. Angle BAC is called the vertical angle.	isosceles_vertical_angle
ABC is a an isosceles triangle with AB and AC being the equal sides. A is called the vertex.	isosceles_vertex
An isosceles triangle is symmetrical about the bisector of its vertical angle.	isosceles_vertical_bisector
An equilateral triangle is symmetrical about the bisector of any of its angles.	equilateral_vertical_bisector
ABCD is a four-sided figure whose sides are all equal, and the diagonal BD is drawn. Show that the angle ABD = the angle ADB.	rhombus_diagnol_1
ABCD is a four-sided figure whose sides are all equal, and the diagonal BD is drawn. Show that the angle CBD = the angle CDB.	rhombus_diagnol_2
ABCD is a four-sided figure whose sides are all equal. Show that the angle ABC = the angle ADC.	rhombus_diagnol_3
ABC, DBC are two isosceles triangles drawn on the same base BC, but on opposite sides of it. Prove that the angle ABD = the angle ACD.	opposite_isosceles_triangles
ABC, DBC are two isosceles triangles drawn on the same base BC and on the same side of it. Prove that the angle ABD = the angle ACD.	sameside_isosceles_triangles
AB, AC are the equal sides of an isosceles triangle ABC and L, M, N are the middle points of AB, BC, and CA respectively. Prove that LM = NM.	isosceles_midpoints_1
AB, AC are the equal sides of an isosceles triangle ABC and L, M, N are the middle points of AB, BC, and CA respectively. Prove that BN = CL.	isosceles_midpoints_2
AB, AC are the equal sides of an isosceles triangle ABC and L, M, N are the middle points of AB, BC, and CA respectively. Prove that the angle ALM = the angle ANM.	isosceles_midpoints_3
If two angles of a triangle are equal to one another, then the sides which are opposite to the equal angles are equal to one another.	angular_isosceles
An equiangular triangle is also equilateral.	equilateral_equiangular
If a triangle is equiangular then it is also equilateral.	equiangular_equilateral
If two triangles have the three sides of the one equal to the three sides of the other, each to each, they are equal in all respects.	scalene_congruent
If two triangles have the three sides of the one equal to the three sides of the other, each to each, they are congruent.	scalene_congruent
If two triangles have the three sides of the one equal to the three sides of the other, the triangles are equiangular to one another.	scalene_equiangular
Show that the straight line which joins the vertex of an isosceles triangle to the middle point of the base, bisects the vertical angle.	isosceles_vertex_midpoint
Show that the straight line which joins the vertex of an isosceles triangle to the middle point of the base, is perpendicular to the base.	isosceles_vertex_perpendicular
If ABCD is a rhombus show by drawing the diagonals AC, BD, that the angle ABC = the angle ADC.	rhombus_diagnols_opposite_angles
If ABCD is a rhombus show by drawing the diagonals AC, BD, that AC bisects each of the angles BAD, BCD.	rhombus_diagnols_diagnol_bisects
If ABCD is a rhombus show by drawing the diagonals AC, BD, that the diagonals bisect one another at right angles.	rhombus_diagnols_right_bisectors
If in a quadrilateral ABCD the opposite sides are equal, namely AB = CD and AD = CB. Prove that the angle ADC = the angle ABC.	parallelogram_opposite_angles
If ABC and DBC are two isosceles triangles drawn on the same side of same base BC, prove that the angle ABD = the angle ACD.	sameside_isosceles_triangles
If ABC and DBC are two isosceles triangles drawn on the opposite sides of the same base BC, prove that the angle ABD = the angle ACD.	opposite_isosceles_triangles
If ABC, DBC are two isosceles triangles drawn on opposite sides of the same base BC, and if AD be joined, prove that each of the angles BAC, BDC will be divided into two equal parts.	opposite_isosceles_triangles_1
Show that the straight lines which join the extremities of the base of an isosceles triangle to the middle points of the opposite sides are equal to one another.	isosceles_base_midpoint
Two given points in the base of an isosceles triangle are equidistant from the extremities of the base. Show that they are also equidistant from the vertex.	isosceles_base_equidistant_points
Show that the triangle formed by joining the middle points of the sides of an equilateral triangle is also equilateral.	equilateral_midpoints
Show that the diagnols of a Rhombus bisect one another at right angles.	rhombus_diagnols_right_bisectors
The equal sides BA, CA of an isosceles triangle BAC are produced beyond the vertex A to the points E and F, so that AE is equal to AF and FB, EC are joined. Show that FB is equal to EC.	isosceles_vertex_extension
If one side of a triangle is produced, then the exterior angle is greater than either of the interior opposite angles.	triangle_exterior_angle
ABC is a triangle. If the side AB is produced in one direction to X, then the exterior angle XCB is greater than either of the interior opposite angles ABC and BAC.	triangle_exterior_angle
Every triangle must have at least two acute angles.	triangle_two_angles
Only one perpendicular can be drawn to a straight line from a given point outside it.	perpendicular_from_point
If AB is a straight line and O is a point outside AB then only one perpendicular can be drawn from O to AB.	perpendicular_from_point
Only one perpendicular can be drawn from a point to a straight line not passing through that point.	perpendicular_from_point
The perpendicular drawn from point O to the line AB is the shortest distance from O to AB.	perpendicular_from_point
ABC is a triangle and D any point within it. If BD and CD are joined, the angle BDC is greater than the angle BAC. Prove this by producing BD to meet AC.	triangle_internal_interior_angle
ABC is a triangle and D any point within it. If BD and CD are joined, the angle BDC is greater than the angle BAC. Prove this by joining AD, and producing it towards the base.	triangle_internal_interior_angle_1
If any side of a triangle is produced both ways, the exterior angles so formed are together greater than two right angles.	triangle_exterior_right_angles
ABC is a triangle. If BC is produced in both directions to X and Y, the exterior angles ABX and ACY are together greater than two right angles.	triangle_exterior_right_angles
To a given straight line there cannot be drawn from a point outside it more than two straight lines of the same given length.	lines_from_point
If the equal sides of an isosceles triangle are produced, the exterior angles must be obtuse.	isosceles_exterior_angles
If one side of a triangle is greater than another, then the angle opposite to the greater side is greater than the angle opposite to the lesser side.	triangle_angles_sides_1
If one angle of a triangle is greater than another, then the side opposite to the greater angle is greater than the side opposite to the lesser angle.	triangle_angles_sides_2
Any two sides of a triangle are together greater than the third side.	triangle_ABC
The shortest distance between two points is the straight line which joins them.	line_AB
The shortest distance points A and B is the line AB.	line_AB
Of all straight lines drawn from a given point to a given straight line the perpendicular is the least.	smallest_line_from_point
If OC is the shortest straight line from O to AB, then OC is perpendicular to AB.	perpendicular_from_point
Two obliques OP, OQ, which cut AB at equal distances from C, the foot of the perpendicular, are equal.	obliques_and_perpendicular
If OP and OQ are oblique lines from O to AB such that CP is equal to CQ where OC is the perpendicular from O to AB, then OP and OQ are also equal.	obliques_and_perpendicular
Of two obliques OQ, OR, if OR cuts AB at the greater distance from C, the foot of the perpendicular, then OR is greater than OQ.	obliques_and_perpendicular_1
The hypotenuse is the greatest side of a right-angled triangle.	right_triangle
If ABC is a right triangle with angle ABC as the right angle, then AC is called the hypotenuse.	right_triangle
If ABC is a right triangle with angle ABC as the right angle, then AC is the greatest side.	right_triangle
The greatest side of any triangle makes acute angles with each of the other sides.	obtuse_triangle_acute_angles
If from the ends of a side of a triangle, two straight lines are drawn to a point within the triangle, then these straight lines are together less than the other two sides of the triangle.	triangle_internal_point
BC, the base of an isosceles triangle ABC, is produced to any point D. Show that AD is greater than either of the equal sides.	isosceles_base_extension
If in a quadrilateral the greatest and least sides are opposite to one another, then each of the angles adjacent to the least side is greater than its opposite angle.	quadrilateral_sides_angles
In a triangle ABC, if AC is not greater than AB, show that any straight line drawn through the vertex A and terminated by the base BC, is less than AB.	triangle_vertex_base
The difference of any two sides of a triangle is less than the third side.	triangle_ABC
The sum of the distances of any point from the three angular points of a triangle is greater than half its perimeter.	triangle_internal_point_1
The sum of the distances of any point within a triangle from its angular points is less than the perimeter of the triangle.	triangle_internal_point_1
In a triangle any two sides are together greater than twice the median which bisects the remaining side. Prove by producing the median.	triangle_median_produced
In any triangle the sum of the medians is less than the perimeter.	triangle_medians
The perimeter of a quadrilateral is greater than the sum of its diagnols.	quadrilateral_diagnols_perimeter
Lines in the same plane that do not meet however far they are produced beyond both ends are called parallel straight lines.	parallel_lines
Two intersecting straight lines cannot both be parallel to a third straight line.	intersecting_parallel
Through a given point there can be only one straight line parallel to a given straight line.	point_parallel_line
When two straight lines AB, CD are met by a third straight line EF, eight angles are formed.	lines_eight_angles
When two straight lines AB, CD are crossed by a third straight line EF, eight angles are formed.	lines_eight_angles
When two straight lines AB, CD are intersected by a third straight line EF, eight angles are formed.	lines_eight_angles
When two straight lines AB, CD are met by a third straight line EF at points X and Y, angles AXE, EXB, CYF, FYD are called exterior angles.	lines_exterior_angles
When two straight lines AB, CD are met by a third straight line EF at points X and Y, angles AXY, BXY, CYX, DYX are called interior angles.	lines_interior_angles
A straight line drawn across a set of given lines is called a transversal.	transversal
If a straight line cuts two parallel lines, it makes the alternate angles equal to one another.	parallel_alternate_angles
If a straight line cuts two parallel lines, it makes the exterior angle equal to the interior opposite angle on the same side of the cutting line.	parallel_interior_opposite_angles
Parallel straight lines have the same direction but differ in position.	parallel_lines
Through any point we may assume a line to pass parallel to any given straight line.	parallel_through_point
Straight lines which are parallel to the same straight line are parallel to one another.	coparallel
Straight lines which are perpendicular to the same straight line are parallel to one another.	coperpendicular
If a straight line meets two or more parallel straight lines, and is perpendicular to one of them, it is also perpendicular to all the others.	same_perpendicular
A radius of a circle is a straight line drawn from the centre to the circumference.	circle_radius
All the radii of a circle are equal.	circle_radii
Any two radii of a circle are equal.	circle_radii
If OA and OB are two radii of a circle, then they are equal.	circle_radii
A diameter of a circle is a straight line drawn through the centre and terminated both ways by the circumference.	diameter
A semicircle is a figure bounded by a diameter of a circle and the part of the circumference cut off by the diameter.	semicircle
Circles that have the same centre are said to be concentric.	concentric_circles
A circle is a closed curve so that if the circumference is crossed by a straight line, this line if produced will cross the circumference at a second point.	line_intersecting_circle
Circles of equal radii are identically equal.	circles
Concentric circles of unequal radii cannot intersect.	concentric_circles
An arc of a circle is any part of the circumference.	arc
A chord of a circle is a straight line, joining any two points on the circumference.	chord
A chord of a circle, which does not pass through the centre, divides the circumference into two unequal arcs. Of these, the greater is called the major arc, and the less minor arc.	chord
The major and minor arcs, into which a circumference is divided by a chord, are said to be conjugate to one another.	chord
Let AB be a straight line and P a point outside it. From P draw PM perpendicular to AB, and produce it to Q, making MQ equal to PM. The points P and Q are said to be symmetrically opposite with regard to the axis AB, and each point is said to be the image of the other in the axis.	symmetry_definition
A point and its image are equidistant from every point on the axis.	symmetry
A circle is symmetncal about any diameter.	circle_diameter_symmetry
A circle has O as the center and AB as any diameter. Prove that the circle is symmetrical about AB.	circle_diameter_symmetry
If a circle passes through a given point P, it also passes through the symmetrically opposite point with regard to any diameter.	circle_diameter_symmetry
In equal circles angles at the centre which stand on equal arcs are equal.	equal_arc_angles
In equal circles arcs which subtend equal angles at the centre are equal.	equal_angle_sectors
In equal circles arcs which are cut off by equal chords are equal, the major arc to the major and the minor arc to the minor.	equal_chord_arcs
In equal circles chords which cut off equal arcs are equal.	equal_arc_chords
In equal circles sectors which have equal angles are equal.	equal_angle_sectors
If a straight line drawn from the center of a circle bisects a chord which does not pass through the center, it cuts the chord at right angles.	chord_center_bisector
If a straight line drawn from the center of a circle cuts the chord at right angles, which does not pass through the center, it bisects the chord.	chord_center_perpendicuar
Let ABC be a circle whose centre is O and let OD bisect a chord AB which does not pass through the centre. Prove that OD is perpendicular to AB.	center_chord_bisector
The straight line which bisects a chord at right angles passes through the centre.	chord_right_bisector
A straight line cannot meet a circle at more than two points.	line_intersecting_circle
A chord of a circle lies wholly within it.	chord
One circle, and only one, can pass through any three points not in the same straight line.	circumcircle_triangle
The size and position of a circle are fully determined if three of its points are known.	three_points_circle
The circle passing through the vertices of a triangle is said to be circumscribed about the triangle. The circle is called the circumcircle of the triangle.	circumcircle_triangle
The circle passing through the vertices of a triangle is said to be circumscribed about the triangle. The circle's radius are called the circumradius of the triangle.	circumradius_triangle
The circle passing through the vertices of a triangle is said to be circumscribed about the triangle. The circle's centre is called the circumcenter of the triangle.	circumcenter_triangle
The parts of a straight line intercepted between the circumferences of two concentric circles are equal.	concentric_circles_intercept
Two circles, whose centres are at A and B, intersect at C, D and M is the middle point of the common chord. Show that AM and BM are in the same straight line.	center_line_common_chord_0
Two circles, whose centres are at A and B, intersect at C, D and M is the middle point of the common chord. Prove that the line of centres bisects the common chord at right angles.	center_line_common_chord_1
AB, AC are two equal chords of a circle, show that the straight line which bisects the angle BAC passes through the centre.	chord_angle_bisector
Find the locus of the centres of all circles which pass through two given points.	two_fixed_points_circle
Describe a circle that shall pass through two given points and have its centre in a given straight line.	given_points_line_circle
Describe a circle of given radius to pass through two given points.	given_points_radius_circle
If from a point within a circle more than two equal straight lines can he drawn to the circumference, that point is the centre of the circle.	internal_point_equidistant_circum
Let ABC be a circle, and O a point within it from which more than two equal straight lines are drawn to the circumference, namely OA,OB,OC. It is required to prove that O is the centre of the circle ABC.	internal_point_equidistant_circum
Equal chords of a circle are equidistant from the centre.	equal_chords
Chords which are equidistant from the centre are equal.	equidistant_chords
Find the locus of the middle points of equal chords of a circle.	loc_midpoints_equal_chords
If two chords of a circle cut one another, and make equal angles with the straight line which joins their point of intersection to the centre, they are equal.	equal_angle_chords
If two equal chords of a circle intersect, show that the segments of the one are equal respectively to the segments of the other.	intersecting_chord_segments
In a given circle draw a chord which shall be equal to one given straight line (not greater than the diameter) and parallel to another.	circle_chord_given_lines
PQ is a fixed chord in a circle, and AB is any diameter. Show that the sum or difference of the perpendiculars let fall from A and B on PQ is the same for all positions of AB.	diameter_chord_perpendiculars
Of any two chords of a circle, that which is nearer to the center is greater than one more remote.	greater_chord_distance
The greater of two chords is nearer to the centre than the less.	greater_chord_distance
The greatest chord in a circle is a diameter.	diameter
Through a given point within a circle draw the least possible chord.	point_smallest_chord
The angle at the centre of a circle is double of an angle at the circumference standing on the same arc.	theorem_39_center_circum_angle
A segment of a circle is the figure bounded by a chord and one of the two arcs into which the chord divides the circumference.	circle_segment
The chord of a segment is called its base.	segment_base
An angle in a segment is one formed by two straight lines drawn from any point in the arc of the segment to the extremities of its chord.	segment_angle
If four or more points are so placed that a circle may be drawn through them, they are said to be concyclic.	concyclic_points
All circles which pass through a fixed point, and have their centres on a given straight line, pass also through a second fixed point.	fixed_point_circle_fixed_line_center
If two circles which intersect are cut by a straight line parallel to the common chord, show that the parts of it intercepted between the circumferences are equal.	intersecting_circles_intercepted_parallel_line
If two circles cut one another, any two parallel straight lines drawn through the points of intersection to cut the circles are equal.	intersecting_circles_parallel_lines
Find the greatest straight line which has one extremity on each of two given non-intersecting circles.	non_intersecting_circles_connecting_line_1
Find the least straight line which has one extremity on each of two given non-intersecting circles.	non_intersecting_circles_connecting_line_2
If from any point on the circumference of a circle straight lines are drawn to the circumference, the greatest is that which passes through the centre.	circle_fixed_circum_point_chords_1
If from any point on the circumference of a circle straight lines are drawn to the circumference, then of any two such lines the greater is that which subtends the greater angle at the centre.	circle_fixed_circum_point_chords_2
Of all straight lines drawn through a point of intersection of two circles and terminated by the circumferences, the greatest is that which is parallel to the line of centres.	intersection_circles_greatest_line
If from any internal point, not the centre, straight lines are drawn to the circumference of a circle, then the greatest is that which passes through the centre and the least is the remaining part of that diameter.	circle_fixed_point_chords
If from any internal point, not the centre, straight lines are drawn to the circumference of a circle then of any two such lines the greater is that which subtends the greater angle at the center.	circle_fixed_point_chords_1
If from any external point straight lines are drawn to the circumference of a circle, the greatest is that which passes through the centre, and the least is that which when produced passes through the centre	circle_fixed_point_chords_2
If from any external point straight lines are drawn to the circumference of a circle then of any other two such lines, the greater is that which subtends the greater angle at the centre.	circle_fixed_point_chords_3
Prove that the angle in a semicircle is a right angle.	semi_circle_right_angle
The angle in, a segment of a circle greater than a semicircle is an acute angle.	major_segment_acute_angle
The angle in a segment of a circle less than a semicircle is an obtuse angle.	minor_segment_obtuse_angle
A circle described on the hypotenuse of a right triangle as diameter, passes through the opposite angular point.	right_triangle_hypotenuse_circle
Two circles intersect at A and B and through A two diameters AP, AQ are drawn, one in each circle. Show that the points P, B, Q are collinear.	intersecting_circles_collinear
A circle is described on one of the equal sides of an isosceles triangle as diameter. Show that it passes through the middle point of the base.	isosceles_side_circle
Circles described on any two sides of a triangle as diameters intersect on the third side, or the third side produced.	triangle_sides_circles
Find the locus of the middle points of chords of a circle drawn through a fixed point, when the given point is within the circumference.	chord_midpoint_fixed_point
Find the locus of the middle points of chords of a circle drawn through a fixed point, when the given point is on the circumference.	chord_midpoint_fixed_circum_point
Find the locus of the middle points of chords of a circle drawn through a fixed point, when the given point is without the circumference.	chord_midpoint_fixed_outside_point
The sum of the arcs cut off by two chords of a circle at right angles to one another is equal to the semi circumference.	chords_right_angles_semi_circum
